40
10
0 0 0 0 0 0 0 0 0 0 0 0 0 0 0 0 0 0 0 0 0 0 0 0 0 0 0 0 0 0 0 0 0 0 0 0 0 0 7 7 
0 0 0 0 0 0 0 0 0 0 0 0 0 0 0 0 0 0 0 0 0 0 0 0 0 0 0 0 0 0 0 0 0 0 0 0 0 0 7 7 
13 13 13 0 0 0 0 0 0 0 0 0 0 0 0 0 0 0 0 0 0 0 0 0 0 0 0 0 0 0 0 0 0 0 0 5 9 0 7 7 
13 13 13 0 0 0 0 0 0 6 6 6 10 10 10 6 6 6 0 0 0 0 0 0 6 6 6 10 10 6 6 6 0 0 0 0 0 0 7 7 
13 13 13 0 0 6 6 0 0 6 6 6 10 10 10 6 6 6 0 0 0 0 0 0 6 6 6 10 10 6 6 6 0 0 0 0 0 0 7 7 
0 0 0 0 0 0 0 0 0 0 0 0 0 0 0 0 0 0 0 0 0 0 0 0 10 6 6 10 10 6 6 10 0 0 8 8 8 8 7 7 
0 0 0 0 0 7 7 0 0 0 0 0 0 0 0 0 0 0 0 0 7 7 0 0 10 6 6 10 10 6 6 10 0 0 8 8 8 8 7 7 
0 0 0 0 6 7 7 0 0 0 0 0 0 0 0 0 0 0 0 0 7 7 0 0 10 6 6 10 10 6 6 10 0 0 8 8 8 8 7 7 
7 7 7 7 7 7 7 7 7 7 7 7 7 7 7 7 7 7 7 7 7 7 7 7 7 7 7 7 7 7 7 7 7 7 7 7 7 7 7 7 
7 7 7 7 7 7 7 7 7 7 7 7 7 7 7 7 7 7 7 7 7 7 7 7 7 7 7 7 7 7 7 7 7 7 7 7 7 7 7 7 
